%s used of %s %s %%=%s brukt av %s (%s %%)
---=
Active tunnels=Aktive tunneller
Activity=Aktivitet
ago=siden
Airflow=Viftestyring
All Apps=Alle programmer
All VMs=Alle VMer
Battery charge=Batterinivå
BIOS dated=BIOS datert
Click to toggle details=Bytt detaljvisning
Completed=Fullført
Counters info=Tellerinfo
Current operation %s on %s=Gjeldende operasjon %s på **%s**
custom image=Egendefinert bilde
Data is invalid=Data er ugyldig
default image=Standardbilde
Docker Containers=Dockercontainere
Due in=Tidsfrist innen
Elapsed time=Tid brukt
Errors info=Feilinformasjon
Estimated finish=Estimert ferdig
failed device=feilet enhet
Fan count=Vifteantall
FAN=Vifte
Finding %s error=Fant **%s** feil
Finding %s errors=Fant **%s** feil
General info=Generell info
Go to cache settings=Gå til bufferinnstillinger
Go to CPU pinning settings=Gå til CPU trådfordeling
Go to disk settings=Gå til diskinnstillinger
Go to Docker settings=Gå til Dockerinnstillinger
Go to fan settings=Gå til vifteinnstillinger
Go to identification settings=Gå til identitestinnstillinger
Go to network settings=Gå til nettverksinnstillinger
Go to scheduler settings=Gå til timeplaninnstillinger
Go to Share settings=Gå til delingsinnstillinger
Go to UPS settings=Gå til UPS-innstillinger
Go to User settings=Gå til brukerinnstillinger
Go to VM settings=Gå til VM-innstillinger
Go to VPN settings=Gå til VPN-innstillinger
Handshake=Forhandlet
has=har
healthy=frisk
heat warning=varmeadvarsel
Hide details=Skjul detaljer
in progress=pågår
Inactive tunnels=Inaktive tunneller
inactive=Inaktiv
Inbound=Inn
invalid device=Ugyldig enhet
invalid devices=Ugyldige enheter
Last check completed on %s=Siste kontroll fullført på **%s**
Last check incomplete on %s=Siste kontroll ble ikke fullført på **%s**
Last checked on %s=Sist kontrollert: **%s**
Maximum size=Maks
Mode of operation=Operasjonsmodus
Next check scheduled on %s=Neste kontroll planlagt på **%s**
No docker containers defined=Ingen dockercontainere er definert
No running docker containers=Ingen dockercontainere
No running virtual machines=Ingen virtuelle maskiner
No shares present=Ingen delte mapper
No virtual machines defined=Ingen virtuelle maskiner definert
Nominal power=Nominell strøm
not received=ikke mottatt
Outbound=Ut
Overall Load=Total last
Parity disk not present=Paritetsdisk er ikke til stede
Parity disks not present=Paritetsdisker er ikke til stede
Parity has not been checked yet=Paritet har ikke blitt kontrollert
Parity is degraded=Pariteten er degradert
Power=Strøm
Put system to sleep=Sett i dvalemodus
Reboot the system=Restart systemet
Receive counters=Mottatt
Received packets=Mottatte pakker
Runtime left=Kjøretid igjen
Scheduled parity check is disabled=Planlagt paritetskontroll er deaktivert
Select Case Model=Velg kabinettmodell
Share count %s with %s cache only and %s encrypted=%s delte mapper, med %s kun på buffer og %s kryptert
Show details=Vis detaljer
Show Information=Vis informasjon
Shutdown the system=Skru av systemet
SMART error=SMART feil
SMART=SMART
sn=s/n
Start the array=Start arrayet
Started only=Kun startet
Stop the array=Stop arrayet
This will put the system to sleep=Dette vil sette systemet i dvalemodus
This will reboot the system=Dette vil restarte systemet
This will shutdown the system=Dette vil skru av systemet
This will start the array=Dette vil starte arrayet
This will stop the array=Dette vil stoppe arrayet
Transmit counters=Sendte
Transmitted packets=Sendte pakker
UPS Load=UPS last
UPS status=UPS status
Usable size=Anvendelig
User count %s with %s unprotected=Antall brukere: %s, med %s som er ubeskyttet
utilization warning=plassvarsel
View Running Processes=Se kjørende prosesser
Virtual Machines=Virtuelle maskiner

; New entries (1) - 2021-03-14
Temp=Temperatur

; New entries (2) - 2021-05-08
%s ago=%s siden
Only PNG images are allowed=Only PNG images are allowed!

; New entries (1) - 2021-05-15
SMART health-check failed=SMART helsekontroll mislykket

; New entries (2) - 2021-05-20
Click to toggle CPU chart=Klikk for å bytte CPU diagram
Network traffic=Nettverkstrafikk
