also remove image=Fjern også bildefil
Apply=Bruk
Are you sure=Er du sikker?
Cancel=Avbryt
checking=sjekker
Completely REMOVE=Fjern fullstendig
Console=Konsoll
day=dag
days=dager
disk image and definition=bildefil og definisjoner
Disks=Disker
Done=Ferdig
Edit=Rediger
Execution error=Kjørefeil
Force Stop=Tving stopp
Hibernate=Hvilemodus
Log for=Logg for:
log=logg
Logs=Logger
More Info=Mer info
No=Nei
OK=OK
Ok=Ok
Pause=Pause
Proceed=Fortsett
Project Page=Prosjektside
Remove container=Fjern container
Remove definition=Fjern definisjoner
Remove image=Fjern bildefil
Remove VM=Fjern VM
Remove=Fjern
Restart=Restart
Resume=Fortsett
Start=Start
Stop=Stopp
Support=Brukerstøtte
Update container=Oppdater container
Update=Oppdater
Updating all Containers=Oppdaterer alle containere
Updating the container=Oppdaterer containeren
VNC Remote=VNC fjernstyring
WebUI=Webgrensesnitt
Yes, delete it=Ja, slett den!
Yes, update it=Ja, oppdater den!
Yes=Ja

; footer messages
Array Starting=Starter arrayet
Array Stopping=Stopper arrayet
Mounting disks=Monterer disker
Spinning up all drives=Spinner opp alle disker
Starting services=Starter tjenester
Stopping services=Stopper tjenester
Unmounting disks=Avmonterer disker
Autostart disabled=Autostart deaktivert
Missing encryption key=Mangler krypteringsnøkkel
Opening encrypted volumes=Åpner krypterte filarkiv

; New entries (5) - 2021-05-08
Container Path=Container Sti
Container Port=Container Port
Container Variable=Container Variabel
Container Label=Container Merke
Container Device=Container Enhet
