%s An update is available=%s: En oppdatering er tilgjengelig
anonymous=anonym
Author=Forfatter
Check For Updates=Se etter oppdateringer
Click here to install version %s=Klikk for å installere %s
DOWNGRADE TO VERSION=NEDGRADER TIL VERSJON
Enter URL of remote plugin file or local plugin file=Skriv inn URL til programtillegget (ekstern eller lokal)
ERROR=FEIL
Install Plugin=Installer programtillegg
Install=Installer
install=installer
Installed Plugins=Installerte programtillegg
Installing Update=Installerer oppdatering
need check=trenger en sjekk
Next=Neste
No release notes available=Ingen utgivelsesnotater er tilgjengelig
Plugin File=Programtilleggsfil
Plugin Update Check=Programtillegg oppdateringssjekk
Plugin=Programtillegg
Release Notes=Utgivelsesnotater
remove=fjern
Select local plugin file=Velg lokal programtilleggsfil
Stable=Stabil
STALE=Ustabil
Support Thread=Brukerstøtte
Uninstall=Avinstaller
Update All Plugins=Oppdater alle programtillegg
Upgrade=Oppgrader
View Release Notes=Se utgivelsesnotater

; New entries (1) - 2021-03-14
No plugins installed=Ingen plugins installert

; New entries (2) - 2021-05-09
Checking connectivty=Kontrollerer tilkobling
No response, aborting=Ingen svar, avbryter

; New entries (1) - 2021-05-10
checking=sjekker

; New entries (3) - 2021-05-10
Delete Plugin=Slett plugin
Remove Plugin=Fjern plugin
Update Plugin=Oppdater plugin

; New entries (2) - 2021-05-15
Plugin File Install Errors=Plugin fil installasjons error
Plugin History=Plugin historie
